...############
..##.#.###...##
.##..###.....##
##...........##
#...@..#......#
###..###..#...#
..#..#....#...#
.##.##.#.##...#
.#......##....#
.#.....##.....#
.##############