##############
#@...........#
#..#......#..#
#.....##.....#
#.....#......#
#..#.....#...#
#...#...#....#
#....###.....#
#............#
#............#
##############